55555555555555555555555555555555555555555555555555555555555555555555555555555555555555555555555555555555555555555555555555555555
55555555555555555555555555555555555555555555555555555555555555555555555555555555555555555555555555555555555555555555555555555555
55555555555555555555555555555555555551155555555555111155555555555555555555555555555555555555555555555555555555555555555555555555
55555555555555555555555555511111111111111111111111111111111111555555551111111111111111111111111111155555555555555555555555555555
55555555555555555555111111111111111111111111111111111111111111555551111111111111111111111111111111111115555555555511111115555555
55555555555555555551111111111111111115555111111111111111111115555555111111111111111111111111111111111111111111111111111111111115
11111555555555555551111111111111111111115511111111111111155555555555511111111111111111111111111111111111111111111111111111111111
11111111111111111111111111111111111111111511111111111111555555555555551111111111111111111111111111111111111111111111111111111111
11111111111111111111111111111111111111111151111111111155555555555551111111111111111111111111111111111111111111111111111111111111
11111111111111111111111111111111111111111115111111115551155555555111111111111111111111111111111111111111111111111111111111111111
51111111111111111111111111111111111111111155511115555511111155111111111111111111111111111111111111111111111111111111111111111115
51111111111111111111111111111111111111111555555555555555555551111111111111111111111111111111111111111111111111111111115511555555
55511111111555555111111111111111111111111115555555555555555511111111111111111111111111111111111111111111111111111115555115555555
55551111155555555111111111111111111111111111155555555555555551111111111111111111111111111111111111111111111111111115555155555555
55555555555555555511111111111111111111111111155555555555555555511111111111111111111111111111111111111111111111111115555155555555
55555555555555555555111111111111111111111111155555555555555555511111111111111111111111111111111111111111111111111111555555555555
55555555555555555555111111111111111111111555555555555555555555511111111111111111111111111111111111111111111111115111555555555555
55555555555555555555111111111111111111111555555555555555555511111555151111111111111111111111111111111111111111155115555555555555
55555555555555555555111111111111111111555555555555555555555511155515515111111111111111111111111111111111111111555115555555555555
55555555555555555555511111111111111115555555555555555555555551551115555551111111111111111111111111111111111111555155555555555555
55555555555555555555511111111111111155555555555555555555555511111111555555551111111111111111111111111111111111511155555555555555
55555555555555555555555111111155511155555555555555555555555111111111111111111111111111111111111111111111111111155555555555555555
55555555555555555555555511111555511155555555555555555555555111111111111111111111111111111111111111111111111115555555555555555555
55555555555555555555555551111551155555555555555555555555551111111111111111115111115151111111111111111111111155555555555555555555
55555555555555555555555555111551155555555555555555555555551111111111111111115111111155551111111111111111111555555555555555555555
55555555555555555555555555111511115555555555555555555555511111111111111111111511111155555111115551111155555555555555555555555555
55555555555555555555555555551151111555555555555555555555511111111111111111111151115555555111155551111155551555555555555555555555
55555555555555555555555555555555515555111155555555555555511111111111111111111151555555555511555555111115551555555555555555555555
55555555555555555555555555555555551111115555555555555555555111111111111111111115115555555511555555111155555155555555555555555555
55555555555555555555555555555555551111111111115555555555555551111111111111111111155555555551155555111115515515555555555555555555
55555555555555555555555555555555555111111111111155555555555555515111111111111111155555555555555555511155515515555555555555555555
55555555555555555555555555555555555111111111111155555555555555555551111111111111555555555555555555111111155555555555555555555555
55555555555555555555555555555555555111111111111111555555555555555551111111141115555555555555555555511111155555555555555555555555
55555555555555555555555555555555555111111111111111115555555555555551111111111155555555555555555555511111151555511155555555555555
55555555555555555555555555555555555111111111111111115555555555555555111111111155555555555555555555555555111155511111555555555555
55555555555555555555555555555555555111111111111111115555555555555555111111111155555555555555555555555555111551111115555555555555
55555555555555555555555555555555555511111111111111155555555555555555111111111155555555555555555555555555555511111111115555555555
55555555555555555555555555555555555555111111111111555555555555555555111111111155155555555555555555555555555111111115555555555555
55555555555555555555555555555555555555111111111111555555555555555555111111111551155555555555555555555555555111111111555555555555
55555555555555555555555555555555555555111111111111555555555555555555111111115551155555555555555555555555551111111111155555555555
55555555555555555555555555555555555555111111111115555555555555555555111111115551155555555555555555555555111111111111115555555555
55555555555555555555555555555555555555111111111555555555555555555555511111115555555555555555555555555555111111111111115555555555
55555555555555555555555555555555555555111111111555555555555555555555511111155555555555555555555555555555111111111111115555555555
55555555555555555555555555555555555555111111115555555555555555555555551111555555555555555555555555555555111111111111115555555555
55555555555555555555555555555555555555111111155555555555555555555555551115555555555555555555555555555555111555511111155555555555
55555555555555555555555555555555555551111111155555555555555555555555555555555555555555555555555555555555555555555111155555555155
55555555555555555555555555555555555551111115555555555555555555555555555555555555555555555555555555555555555555555511555555555115
55555555555555555555555555555555555551111115555555555555555555555555555555555555555555555555555555555555555555555551555555551555
55555555555555555555555555555555555551111155555555555555555555555555555555555555555555555555555555555555555555555555555555555555
55555555555555555555555555555555555551111155555555555555555555555555555555555555555555555555555555555555555555555555555555555555
55555555555555555555555555555555555551111111555555555555555555555555555555555555555555555555555555555555555555555555555555555555
55555555555555555555555555555555555555111555555555555555555555555555555555555555555555555555555555555555555555555555555555555555
55555555555555555555555555555555555555555555555555555555555555555555555555555555555555555555555555555555555555555555555555555555
55555555555555555555555555555555555555555555555555555555555555555555555555555555555555555555555555555555555555555555555555555555
55555555555555555555555555555555555555555511555555555555555555555555555555555555555555555555555555555555555555555555555555555555
55555555555555555555555555555555555551111111555555555555555555555555555555555511111111111111111111111111111111111111115555555555
55555555555555555555555555555555511111111111555555555555555555511111111111111111111111111111111111111111111111111111111555555555
55555555555555555555555551111111111111111111115555555555555111111111111111111111111111111111111111111111111111111111111111155555
55555555555555555111111151111111111111111111111555555555111111111111111111111111111111111111111111111111111111111111111111111111
11111111111111111111111111111111111111111111111111111111111111111111111111111111111111111111111111111111111111111111111111111111
11111111111111111111111111111111111111111111111111111111111111111111111111111111111111111111111111111111111111111111111111111111
11111111111111111111111111111111111111111111111111111111111111111111111111111111111111111111111111111111111111111111111111111111
11111111111111111111111111111111111111111111111111111111111111111111111111111111111111111111111111111111111111111111111111111111
11111111111111111111111111111111111111111111111111111111111111111111111111111111111111111111111111111111111111111111111111111111
11111111111111111111111111111111111111111111111111111111111111111111111111111111111111111111111111111111111111111111111111111111
