22222222222222222222222222222222222222222222222222222222222222222222222222222222222222222222222222222222222222222222222222222222
22222222222222222222222222222222222222222222222222222222222222222222222222222222222222222222222222222222222222222222222222222222
22222222222222222222222222222222222223322222222222333322222222222222222222222222222222222222222222222222222222222222222222222222
22222222222222222222222222233333333333333333333333333333333333222222223333333333333333333333333333322222222222222222222222222222
22222222222222222222333333333333333333333333333333333333333333222223333333333333333333333333333333333332222222222200000002222222
22222222222222222223333333333333333332222333333333333333333332222222333333333333333333333333333333333333000000000000000000000002
00000222222222222223333333333333333333332233333333333333322222222222233333333333333333333333333330030000000000000000000000000000
00000000000000000033333333333333333333333233333333333333222222222222223333333333333333333333333333333330000033300000000000333330
00000033333330333333333333333333333333333323333333333322222222222223333333333333333333333333333333330000000033300000000000003330
00330000000000000000333333333333333333333332333333332220022222222333333333333333330333300000003333330000000033000000000000000000
00000000033333333333333333333333333333333322233332222200000022333333333333333330000330000000000000000000000000000000000000033330
00000033033333333333333333333333333333333222222222222222222223333333333333333330000000000000000000000000000000000000000000000000
00033333333000000333333333333333333333333332222222220000000233333333333333333000000000000000000000000000000000000000000000000000
00003333300000000333333333333333333333333333322222000000000023333003333333300000000000000000000000000000000000000000000000000000
00000000000000000033333333333333333333333333322220000000000022200000000000000000000000000000000000000000000000000000000000000000
00000000000000000000333333333333333333333333322200000000000002200000000000000000000000000000000000000000000000000000000000000000
00000000000000000000000303003330333333333222200000000000000000000000000000000000000000000000000000000000000000000000000000000000
00000000000000000000030000000030333333333222200000000000000000000000000000000000000000000000000000000000000000000000000000000000
00000000000000000000030000000000000000000000000000000000000000000000000000000000000000000000000000000000000000000000000000000000
00000000000000000000003000000000000000000000000000000000000000000000000000000000000000000000000000000000000000000000000000000000
00000000000000000000000000000000000000000000000000000000000000000000000000000000000000000000000000000000000000000000000000000000
00000000000000000000000000000000000000000000000000000000000000000000000000000000000000000000000000000000000000000000000000000000
00000000000000000000000000000000000000000000000000000000000000000000000000000000000000000000000000000000000000000000000000000000
00000000000000000000000000000000000000000000000000000000000000000000000000000000000000000000000000000000000000000000000000000000
00000000000000000000000000000000000000000000000000000000000000000000000000000000000000000000000000000000000000000000000000000000
00000000000000000000000000000000000000000000000000000000000000000000000000000000000000000000000000000000000000000000000000000000
00000000000000000000000000000000000000000000000000000000000000000000000000000000000000000000000000000000000000000000000000000000
00000000000000000000000000000000000000000000000000000000000000000000000000000000000000000000000000000000000000000000000000000000
00000000000000000000000000000000000000000000000000000000000000000000000000000000000000000000000000000000000000000000000000000000
00000000000000000000000000000000000000000000000000000000000000000000000000000000000000000000000000000000000000000000000000000000
00000000000000000000000000000000000000000000000000000000000000000000000000000000000000000000000000000000000000000000000000000000
00000000000000000000000000000000000000000000000000000000000000000000000000000000000000000000000000000000000000000000000000000000
00000000000000000000000000000000000000000000000000000000000000000000000000040000000000000000000000000000000000000000000000000000
00000000000000000000000000000000000000000000000000000000000000000000000000000000000000000000000000000000000000000000000000000000
00000000000000000000000000000000000030000000000000000000000000000000000000000000000000000000000000000000000000000000000000000000
00000000000000000000000000000000000030000000000000000000000000000000000000000000000000000000000000000000000000000000000000000000
00000000000000000000000000000000000003000000000000000000000000000000000000000000000000000000000000000000000000000000000000000000
00000000000000000000000000000000000000303000000000000000000000000000000000000000000000000000000000000000000000000000000000000000
00000000000000000000000000000000000000303000000000000000000000000000000000000000000000000000000000000000000000000000000000000000
00000000000000000000000000000000000000003000000000000000000000000000000000000000000000000000000000000000000000000000000000000000
00000000000000000000000000000000000000000000000000000000000000000000000000000000000000000000000000000000000000000000000000000000
00000000000000000000000000000000000000000000000000000000000000000000000000000000000000000000000000000000000000000000000000000000
00000000000000000000000000000000000000000000000000000000000000000000000000000000000000000000000000000000000000000000000000000000
00000000000000000000000000000000000000000000000000000000000000000000000000000000000000000000000000000000000000000000000000000000
00000000000000000000000000000000000000000000000000000000000000000000000000000000000000000000000000000000000000000000000000000000
00000000000000000000000000000000000000000000000000000000000000000000000000000000000000000000000000000000000000000000000000000000
00000000000000000000000000000000000000000000000000000000000000000000000000000000000000000000000000000000000000000000000000000000
00000000000000000000000000000000000000000000000000000000000000000000000000000000000000000000000000000000000000000000000000000000
00000000000000000000000000000000000000000000000000000000000000000000000000000000000000000000000000000000000000000000000000000000
00000000000000000000000000000000000003000000000000000000000000000000000000000000000000000000000000000000000000000000000000000000
00000000000000000000000000000000000003000000000000022222222222200000000000000000000000000000000000000000000000000000000000000000
00000000000000000000000000000000000000000000022222222222222222222222200000000022222222222222222222222222222222222222000000000000
00000000000000000000000000000000000000000002222222222222222222222222222222222222222222222222222222222222222222222222000000000000
22222222222222200000000000000000000000000222222222222222222222222222222222222222222222222222222222222222222222222222222222222222
22222222222222222222222222222222222222222233222222222222222222222222222222222222222222222222222222222222222222222222222222222222
22222222222222222222222222222222222223333333222222222222222222222222222222222233333333333333333333333333333333333333332222222222
22222222222222222222222222222222233333333333222222222222222222233333333333333333333333333333333333333333333333333333333222222222
22222222222222222222222223333333333333333333332222222222222333333333333333333333333333333333333333333333333333333333333333322222
22222222222222222333333323333333333333333333333222222222333333333333333333333333333333333333333333333333333333333333333333333333
33333333333333333333333333333333333333333333333333333333333333333333333333333333333333333333333333333333333333333333333333333333
33333333333333333333333333333333333333333333333333333333333333333333333333333333333333333333333333333333333333333333333333333333
33333333333333333333333333333333333333333333333333333333333333333333333333333333333333333333333333333333333333333333333333333333
33333333333333333333333333333333333333333333333333333333333333333333333333333333333333333333333333333333333333333333333333333333
33333333333333333333333333333333333333333333333333333333333333333333333333333333333333333333333333333333333333333333333333333333
33333333333333333333333333333333333333333333333333333333333333333333333333333333333333333333333333333333333333333333333333333333
