55555555555555555555555555555555555555555555555555555555555555555555555555555555555555555555555555555555555555555555555555555555
55555555555555555555555555555555555555555555555555555555555555555555555555555555555555555555555555555555555555555555555555555555
55555555555555555555555555555555555555555555555555555555555555555555555555555555555555555555555555555555555555555555555555555555
55555555555555555555555555555551111111115111111111111111111555555555555555555555555555555555555555555555555555555555555555555555
55555555555555555555555555115511111115111111111111111111155555555551111555555555555555555555555555511555555555555555555555555555
55555555555555555555511111515511555555515511111111111111155555555555555555555555555551155555555555111155555555551155555555555555
55555555555555555555111551551115111115555555111111111111155555555555555555555555515555555555551111111111111115555555555555555555
55555511111155555555551111115115111111155555111111111111555555555555555111155555555555511111111111111111111111111111111111555555
15555111111111111111111111111111111551111555111111115555555555555555511111111111111111111111111111111111111111111111111111111111
51551111111111111111111111111111111151115555511115555551111555555551111511111111111111111111111111111111111111111111111111111115
55551111111111111111111111111115555111555555551155555555555555555111115111111111111111111111111111111111111111111111111111111155
55555511155555111111111111111155555111151555555555555555555555555111115511111111111111111111111111111111111111111111115511555555
55555515555555551111111111111111155511111155555555555555555551155515155111111111111111111111111111111111111111111555555111555555
55555555555555555111111111111111115111111111555555555555555515115511111111111111111111111111111111111111111111111155555155555555
55555555555555555511111111111111111111111111555555555555555555151111111111111111111111111111111111111111111111111115555555555555
55555555555555555551111111111111511111115511155555555555555555111111111111111111111111111111111111111111111111111555555555555555
55555555555555555551111111111111111111111155555555555555555555511111111111551111551111111111111111111111111111115555555555555555
55555555555555555551111111111111111111555555555555555555555511111555151115555511151111111111111111111111111111555115555555555555
55555555555555555555111111111111111115555555555555555555555511115555515111111111155111111111111111111111111515555155555555555555
55555555555555555555111111111111111115555555555555555555555551551115555551111111111111111111111111111111115511551155555555555555
55555555555555555555511111111111111155555555555555555555555511111111555555551111111111111111111111111111111555515555555555555555
55555555555555555555551111111111111555555555555555555555555511111111111111111111111111111111111111111111111555555555555555555555
55555555555555555555555511111555551555555555555555555555555111111111111111111111151111111111111111111111115555555555555555555555
55555555555555555555555551111555555555555555555555555555551111111111111111115111115151111111111111111111115555555555555555555555
55555555555555555555555555111555551155555555555555555555551111111111111111115111111155551111111111111111155555555555555555555555
55555555555555555555555555111551555555555555555555555555551111111111111111111511111155555111115551111515555555555555555555555555
55555555555555555555555555551111555555555555555555555555511111111111111111111151115555555111155551111155551555555555555555555555
55555555555555555555555555555551115555555555555555555555511111111111111111111151555555555511555555111115551555555555555555555555
55555555555555555555555555555555515551111555555555555555551111111111111111111115115555555511555555151155555155555555555555555555
55555555555555555555555555555555551511111115555555555555555111111111111111111111155555555551155555155555555155555555555555555555
55555555555555555555555555555555555511111111155555555555555511115111111111111111155555555555555555515555155555555555555555555555
55555555555555555555555555555555555511111111115555555555555555555551111111111111555555555555555555115551155555555555555555555555
55555555555555555555555555555555555111111111115555555555555555555551111111151115555555555555555555515511155555555555555555555555
55555555555555555555555555555555551111111111111111555555555555555551111111111155555555555555555555511551151555511155555555555555
55555555555555555555555555555555555111111111111111155555555555555555111111111155555555555555555555555155555555551115555555555555
55555555555555555555555555555555555111111111111111155555555555555555111111111155555555555555555555555555555555555115555555555555
55555555555555555555555555555555555511111111111111155555555555555555111111111155555555555555555555555555555555555555555555555555
55555555555555555555555555555555555511111111111111555555555555555555111111111155155555555555555555555555555515115515555555555555
55555555555555555555555555555555555551111111111111555555555555555555111111111551155555555555555555555555555111111511555555555555
55555555555555555555555555555555555555111111111115555555555555555555111111115551155555555555555555555555551111111111555555555555
55555555555555555555555555555555555555111111111115555555555555555555111111115551155555555555555555555555111111111111155555555555
55555555555555555555555555555555555555111111111555555555555555555555511111115555555555555555555555555555111111111111115555555555
55555555555555555555555555555555555555111111115555555555555555555555511111155555555555555555555555555555111111111111115555555555
55555555555555555555555555555555555555111111115555555555555555555555551111555555555555555555555555555555111111111111115555555555
55555555555555555555555555555555555555111111155555555555555555555555551115555555555555555555555555555555111555511111155555555555
55555555555555555555555555555555555551111111555555555555555555555555555555555555555555555555555555555555555555555111155555555155
55555555555555555555555555555555555551111155555555555555555555555555555555555555555555555555555555555555555555555555555555555115
55555555555555555555555555555555555551111555555555555555555555555555555555555555555555555555555555555555555555555551555555551555
55555555555555555555555555555555555551115555555555555555555555555555555555555555555555555555555555555555555555555555555555515555
55555555555555555555555555555555555551115555555555555555555555555555555555555555555555555555555555555555555555555555555555555555
55555555555555555555555555555555555551155555555555555555555555555555555555555555555555555555555555555555555555555555555555555555
55555555555555555555555555555555555555155555555555555555555555555555555555555555555555555555555555555555555555555555555555555555
55555555555555555555555555555555555555555555555555555555555555555555555555555555555555555555555555555555555555555555555555555555
55555555555555555555555555555555555555555555555555555555555555555555555555555555555555555555555555555555555555555555555555555555
55555555555555555555555555555555555555555555555555555555555555555555555555555555555555555555555555555555555555555555555555555555
55555555555555555555555555555555555555555515555555555555555555555555555555555555555555555555555555555555555555555555555555555555
55555555555555555555555555555555555555551155555555555555555555555555555555555555511115555555111111111111111111111115555555555555
55555555555555555555555555555555555551111155555555555555555555111111111111111111111111111111111111111111111111111111111155555555
55555555555555555555555555511111111111111155555555555555511111111111111111111111111111111111111111111111111111111111111115555555
11111111111111111111111111111111111111111115555555555511111111111111111111111111111111111111111111111111111111111111111111111111
11111111111111111111111111111111111111111111111111111111111111111111111111111111111111111111111111111111111111111111111111111111
11111111111111111111111111111111111111111111111111111111111111111111111111111111111111111111111111111111111111111111111111111111
11111111111111111111111111111111111111111111111111111111111111111111111111111111111111111111111111111111111111111111111111111111
11111111111111111111111111111111111111111111111111111111111111111111111111111111111111111111111111111111111111111111111111111111
11111111111111111111111111111111111111111111111111111111111111111111111111111111111111111111111111111111111111111111111111111111
